Date,Date_YMD,Daily Confirmed,Total Confirmed,Daily Recovered,Total Recovered,Daily Deceased,Total Deceased
30 Jan 2020,2020-01-30,1,1,0,0,0,0
02 Feb 2020,2020-02-02,1,2,0,0,0,0
03 Feb 2020,2020-02-03,1,3,0,0,0,0
14 Feb 2020,2020-02-14,0,3,3,3,0,0
02 Mar 2020,2020-03-02,2,5,0,3,0,0
03 Mar 2020,2020-03-03,1,6,0,3,0,0
04 Mar 2020,2020-03-04,22,28,0,3,0,0
05 Mar 2020,2020-03-05,2,30,0,3,0,0
06 Mar 2020,2020-03-06,1,31,0,3,0,0
07 Mar 2020,2020-03-07,3,34,0,3,0,0
08 Mar 2020,2020-03-08,5,39,0,3,0,0
09 Mar 2020,2020-03-09,9,48,0,3,0,0
10 Mar 2020,2020-03-10,15,63,0,3,0,0
11 Mar 2020,2020-03-11,8,71,0,3,0,0
12 Mar 2020,2020-03-12,10,81,0,3,0,0
13 Mar 2020,2020-03-13,10,91,0,3,1,1
14 Mar 2020,2020-03-14,11,102,0,3,0,1
15 Mar 2020,2020-03-15,10,112,0,3,0,1
16 Mar 2020,2020-03-16,14,126,0,3,0,1
17 Mar 2020,2020-03-17,20,146,0,3,0,1
18 Mar 2020,2020-03-18,25,171,0,3,0,1
19 Mar 2020,2020-03-19,27,198,0,3,0,1
20 Mar 2020,2020-03-20,58,256,1,4,0,1
21 Mar 2020,2020-03-21,78,334,0,4,0,1
22 Mar 2020,2020-03-22,69,403,0,4,0,1
23 Mar 2020,2020-03-23,94,497,0,4,0,1
24 Mar 2020,2020-03-24,74,571,2,6,0,1
25 Mar 2020,2020-03-25,86,657,0,6,0,1
26 Mar 2020,2020-03-26,73,730,0,6,1,2
27 Mar 2020,2020-03-27,153,883,2,8,1,3
28 Mar 2020,2020-03-28,136,1019,0,8,0,3
29 Mar 2020,2020-03-29,120,1139,91,99,25,28
30 Mar 2020,2020-03-30,187,1326,42,141,13,41
31 Mar 2020,2020-03-31,309,1635,19,160,6,47
01 Apr 2020,2020-04-01,424,2059,9,169,11,58
02 Apr 2020,2020-04-02,486,2545,22,191,11,69
03 Apr 2020,2020-04-03,560,3105,39,230,14,83
04 Apr 2020,2020-04-04,579,3684,56,286,13,96
05 Apr 2020,2020-04-05,609,4293,43,329,22,118
06 Apr 2020,2020-04-06,484,4777,65,394,16,134
07 Apr 2020,2020-04-07,573,5350,75,469,27,161
08 Apr 2020,2020-04-08,565,5915,96,565,20,181
09 Apr 2020,2020-04-09,813,6728,70,635,46,227
10 Apr 2020,2020-04-10,871,7599,151,786,22,249
11 Apr 2020,2020-04-11,854,8453,186,972,41,290
12 Apr 2020,2020-04-12,758,9211,114,1086,42,332
13 Apr 2020,2020-04-13,1243,10454,112,1198,27,359
14 Apr 2020,2020-04-14,1031,11485,167,1365,37,396
15 Apr 2020,2020-04-15,886,12371,144,1509,27,423
16 Apr 2020,2020-04-16,1061,13432,258,1767,26,449
17 Apr 2020,2020-04-17,922,14354,273,2040,38,487
18 Apr 2020,2020-04-18,1371,15725,426,2466,35,522
19 Apr 2020,2020-04-19,1580,17305,388,2854,38,560
20 Apr 2020,2020-04-20,1239,18544,419,3273,33,593
21 Apr 2020,2020-04-21,1537,20081,703,3976,53,646
22 Apr 2020,2020-04-22,1292,21373,394,4370,36,682
23 Apr 2020,2020-04-23,1667,23040,642,5012,40,722
24 Apr 2020,2020-04-24,1408,24448,484,5496,59,781
25 Apr 2020,2020-04-25,1835,26283,442,5938,44,825
26 Apr 2020,2020-04-26,1607,27890,585,6523,56,881
27 Apr 2020,2020-04-27,1568,29458,580,7103,58,939
28 Apr 2020,2020-04-28,1902,31360,636,7739,69,1008
29 Apr 2020,2020-04-29,1705,33065,690,8429,71,1079
30 Apr 2020,2020-04-30,1802,34867,630,9059,75,1154
01 May 2020,2020-05-01,2396,37263,962,10021,77,1231
02 May 2020,2020-05-02,2564,39827,831,10852,92,1323
03 May 2020,2020-05-03,2952,42779,911,11763,140,1463
04 May 2020,2020-05-04,3656,46435,1082,12845,103,1566
05 May 2020,2020-05-05,2971,49406,1295,14140,128,1694
06 May 2020,2020-05-06,3602,53008,1161,15301,91,1785
07 May 2020,2020-05-07,3344,56352,1475,16776,104,1889
08 May 2020,2020-05-08,3339,59691,1111,17887,97,1986
09 May 2020,2020-05-09,3175,62866,1414,19301,116,2102
10 May 2020,2020-05-10,4311,67177,1669,20970,112,2214
11 May 2020,2020-05-11,3592,70769,1579,22549,81,2295
12 May 2020,2020-05-12,3562,74331,1905,24454,120,2415
13 May 2020,2020-05-13,3726,78057,1963,26417,137,2552
14 May 2020,2020-05-14,3991,82048,1594,28011,97,2649
15 May 2020,2020-05-15,3808,85856,2234,30245,104,2753
16 May 2020,2020-05-16,4794,90650,4012,34257,120,2873
17 May 2020,2020-05-17,5049,95699,2538,36795,152,3025
18 May 2020,2020-05-18,4628,100327,2482,39277,131,3156
19 May 2020,2020-05-19,6154,106481,3032,42309,146,3302
20 May 2020,2020-05-20,5720,112201,3113,45422,134,3436
21 May 2020,2020-05-21,6023,118224,3131,48553,148,3584
22 May 2020,2020-05-22,6536,124760,3280,51833,142,3726
23 May 2020,2020-05-23,6665,131425,2576,54409,142,3868
24 May 2020,2020-05-24,7111,138536,3285,57694,156,4024
25 May 2020,2020-05-25,6414,144950,3012,60706,149,4173
26 May 2020,2020-05-26,5907,150857,3585,64291,173,4346
27 May 2020,2020-05-27,7246,158103,3434,67725,188,4534
28 May 2020,2020-05-28,7254,165357,3171,70896,176,4710
29 May 2020,2020-05-29,8138,173495,11735,82631,268,4978
30 May 2020,2020-05-30,8364,181859,4303,86934,205,5183
31 May 2020,2020-05-31,8789,190648,4928,91862,222,5405
01 Jun 2020,2020-06-01,7724,198372,3882,95744,201,5606
02 Jun 2020,2020-06-02,8812,207184,4531,100275,222,5828
03 Jun 2020,2020-06-03,9688,216872,3789,104064,259,6087
04 Jun 2020,2020-06-04,9847,226719,4390,108454,274,6361
05 Jun 2020,2020-06-05,9472,236191,4771,113225,286,6647
06 Jun 2020,2020-06-06,10408,246599,5433,118658,297,6944
07 Jun 2020,2020-06-07,10882,257481,5191,123849,261,7205
08 Jun 2020,2020-06-08,8536,266017,5171,129020,271,7476
09 Jun 2020,2020-06-09,9981,275998,5634,134654,272,7748
10 Jun 2020,2020-06-10,11156,287154,6275,140929,358,8106
11 Jun 2020,2020-06-11,11135,298289,6044,146973,394,8500
12 Jun 2020,2020-06-12,11306,309595,7263,154236,388,8888
13 Jun 2020,2020-06-13,12039,321634,8091,162327,309,9197
14 Jun 2020,2020-06-14,11404,333038,7358,169685,324,9521
15 Jun 2020,2020-06-15,10032,343070,10640,180325,396,9917
16 Jun 2020,2020-06-16,11085,354155,7226,187551,2004,11921
17 Jun 2020,2020-06-17,13108,367263,6890,194441,341,12262
18 Jun 2020,2020-06-18,13829,381092,10741,205182,343,12605
19 Jun 2020,2020-06-19,14740,395832,9029,214211,364,12969
20 Jun 2020,2020-06-20,15918,411750,13974,228185,308,13277
21 Jun 2020,2020-06-21,15151,426901,9075,237260,426,13703
22 Jun 2020,2020-06-22,13560,440461,10879,248139,312,14015
23 Jun 2020,2020-06-23,15656,456117,10462,258601,468,14483
24 Jun 2020,2020-06-24,16868,472985,13089,271690,424,14907
25 Jun 2020,2020-06-25,18205,491190,13983,285673,401,15308
26 Jun 2020,2020-06-26,18255,509445,10246,295919,381,15689
27 Jun 2020,2020-06-27,20142,529587,14229,310148,414,16103
28 Jun 2020,2020-06-28,19610,549197,11631,321779,384,16487
29 Jun 2020,2020-06-29,18339,567536,13497,335276,417,16904
30 Jun 2020,2020-06-30,18255,585791,12565,347841,506,17410
01 Jul 2020,2020-07-01,19430,605221,12064,359905,438,17848
02 Jul 2020,2020-07-02,21947,627168,19999,379904,378,18226
03 Jul 2020,2020-07-03,22718,649886,14417,394321,444,18670
04 Jul 2020,2020-07-04,24018,673904,14746,409067,611,19281
05 Jul 2020,2020-07-05,23942,697846,15829,424896,421,19702
06 Jul 2020,2020-07-06,22500,720346,15315,440211,473,20175
07 Jul 2020,2020-07-07,23148,743494,16838,457049,479,20654
08 Jul 2020,2020-07-08,25561,769055,19508,476557,492,21146
09 Jul 2020,2020-07-09,25790,794845,19408,495965,479,21625
10 Jul 2020,2020-07-10,27749,822594,20289,516254,520,22145
11 Jul 2020,2020-07-11,27754,850348,19981,536235,541,22686
12 Jul 2020,2020-07-12,29106,879454,18198,554433,497,23183
13 Jul 2020,2020-07-13,28178,907632,17683,572116,541,23724
14 Jul 2020,2020-07-14,29917,937549,20976,593092,582,24306
15 Jul 2020,2020-07-15,32607,970156,20646,613738,614,24920
16 Jul 2020,2020-07-16,35468,1005624,22867,636605,680,25600
17 Jul 2020,2020-07-17,34824,1040448,17486,654091,676,26276
18 Jul 2020,2020-07-18,37411,1077859,23582,677673,543,26819
19 Jul 2020,2020-07-19,40235,1118094,22730,700403,675,27494
20 Jul 2020,2020-07-20,36806,1154900,24303,724706,596,28090
21 Jul 2020,2020-07-21,39170,1194070,27589,752295,671,28761
22 Jul 2020,2020-07-22,45601,1239671,31875,784170,1130,29891
23 Jul 2020,2020-07-23,48443,1288114,33326,817496,755,30646
24 Jul 2020,2020-07-24,48888,1337002,32514,850010,763,31409
25 Jul 2020,2020-07-25,50072,1387074,37125,887135,703,32112
26 Jul 2020,2020-07-26,48932,1436006,31512,918647,704,32816
27 Jul 2020,2020-07-27,46484,1482490,34354,953001,642,33458
28 Jul 2020,2020-07-28,49631,1532121,35683,988684,774,34232
29 Jul 2020,2020-07-29,52479,1584600,32886,1021570,775,35007
30 Jul 2020,2020-07-30,54968,1639568,37425,1058995,784,35791
31 Jul 2020,2020-07-31,57486,1697054,36554,1095549,765,36556
01 Aug 2020,2020-08-01,55117,1752171,51368,1146917,854,37410
02 Aug 2020,2020-08-02,52672,1804843,40355,1187272,760,38170
03 Aug 2020,2020-08-03,50491,1855334,43070,1230342,806,38976
04 Aug 2020,2020-08-04,51282,1906616,51220,1281562,849,39825
05 Aug 2020,2020-08-05,56626,1963242,45583,1327145,919,40744
06 Aug 2020,2020-08-06,62170,2025412,50141,1377286,899,41643
07 Aug 2020,2020-08-07,61455,2086867,50387,1427673,936,42579
08 Aug 2020,2020-08-08,65156,2152023,52135,1479808,875,43454
09 Aug 2020,2020-08-09,62117,2214140,54474,1534282,1013,44467
10 Aug 2020,2020-08-10,53016,2267156,47362,1581644,887,45354
11 Aug 2020,2020-08-11,61252,2328408,56461,1638105,835,46189
12 Aug 2020,2020-08-12,67066,2395474,57759,1695864,950,47139
13 Aug 2020,2020-08-13,64141,2459615,54776,1750640,1006,48145
14 Aug 2020,2020-08-14,65610,2525225,56920,1807560,989,49134
15 Aug 2020,2020-08-15,63986,2589211,53116,1860676,952,50086
16 Aug 2020,2020-08-16,58096,2647307,57404,1918080,952,51038
17 Aug 2020,2020-08-17,54298,2701605,58172,1976252,880,51918
18 Aug 2020,2020-08-18,65024,2766629,60455,2036707,1099,53017
19 Aug 2020,2020-08-19,69196,2835825,59365,2096072,979,53996
20 Aug 2020,2020-08-20,68518,2904343,61873,2157945,981,54977
21 Aug 2020,2020-08-21,69029,2973372,62858,2220803,953,55930
22 Aug 2020,2020-08-22,70067,3043439,59101,2279904,918,56848
23 Aug 2020,2020-08-23,61749,3105188,56896,2336800,846,57694
24 Aug 2020,2020-08-24,59696,3164884,66305,2403105,854,58548
25 Aug 2020,2020-08-25,66873,3231757,64151,2467256,1066,59614
26 Aug 2020,2020-08-26,75995,3307752,56191,2523447,1017,60631
27 Aug 2020,2020-08-27,76827,3384579,59620,2583067,1066,61697
28 Aug 2020,2020-08-28,76657,3461236,64475,2647542,1019,62716
29 Aug 2020,2020-08-29,78479,3539715,64982,2712524,943,63659
30 Aug 2020,2020-08-30,79461,3619176,60422,2772946,960,64619
31 Aug 2020,2020-08-31,68766,3687942,64435,2837381,816,65435
01 Sep 2020,2020-09-01,78168,3766110,62147,2899528,1027,66462
02 Sep 2020,2020-09-02,82865,3848975,67876,2967404,1026,67488
03 Sep 2020,2020-09-03,84159,3933134,67510,3034914,1083,68571
04 Sep 2020,2020-09-04,87107,4020241,69604,3104518,1066,69637
05 Sep 2020,2020-09-05,90606,4110847,73165,3177683,1044,70681
06 Sep 2020,2020-09-06,91725,4202572,69630,3247313,1005,71686
07 Sep 2020,2020-09-07,75015,4277587,74116,3321429,1129,72815
08 Sep 2020,2020-09-08,89855,4367442,74608,3396037,1107,73922
09 Sep 2020,2020-09-09,95536,4462978,73062,3469099,1168,75090
10 Sep 2020,2020-09-10,96762,4559740,70904,3540003,1213,76303
11 Sep 2020,2020-09-11,97655,4657395,81456,3621459,1202,77505
12 Sep 2020,2020-09-12,94414,4751809,77862,3699321,1111,78616
13 Sep 2020,2020-09-13,93220,4845029,77748,3777069,1140,79756
14 Sep 2020,2020-09-14,81909,4926938,79208,3856277,1054,80810
15 Sep 2020,2020-09-15,91097,5018035,82854,3939131,1281,82091
16 Sep 2020,2020-09-16,97860,5115895,82924,4022055,1140,83231
17 Sep 2020,2020-09-17,96787,5212682,87788,4109843,1175,84406
18 Sep 2020,2020-09-18,92973,5305655,95515,4205358,1221,85627
19 Sep 2020,2020-09-19,92574,5398229,94389,4299747,1149,86776
20 Sep 2020,2020-09-20,87395,5485624,92926,4392673,1135,87911
21 Sep 2020,2020-09-21,74493,5560117,102075,4494748,1056,88967
22 Sep 2020,2020-09-22,83362,5643479,89657,4584405,1085,90052
23 Sep 2020,2020-09-23,86703,5730182,87459,4671864,1123,91175
24 Sep 2020,2020-09-24,85921,5816103,81142,4753006,1144,92319
25 Sep 2020,2020-09-25,85717,5901820,93331,4846337,1093,93412
26 Sep 2020,2020-09-26,88759,5990579,92365,4938702,1124,94536
27 Sep 2020,2020-09-27,82770,6073349,74691,5013393,1040,95576
28 Sep 2020,2020-09-28,69669,6143018,85198,5098591,775,96351
29 Sep 2020,2020-09-29,80500,6223518,86150,5184741,1178,97529
30 Sep 2020,2020-09-30,86748,6310266,85274,5270015,1179,98708
01 Oct 2020,2020-10-01,81785,6392051,78731,5348746,1099,99807
02 Oct 2020,2020-10-02,79885,6471936,76340,5425086,1068,100875
03 Oct 2020,2020-10-03,75479,6547415,81655,5506741,937,101812
04 Oct 2020,2020-10-04,74770,6622185,76715,5583456,903,102715
05 Oct 2020,2020-10-05,60130,6682315,75857,5659313,886,103601
06 Oct 2020,2020-10-06,71869,6754184,81945,5741258,990,104591
07 Oct 2020,2020-10-07,78809,6832993,83210,5824468,963,105554
08 Oct 2020,2020-10-08,70798,6903791,78745,5903213,967,106521
09 Oct 2020,2020-10-09,73305,6977096,82628,5985841,929,107450
10 Oct 2020,2020-10-10,74418,7051514,89024,6074865,921,108371
11 Oct 2020,2020-10-11,67789,7119303,71565,6146430,813,109184
12 Oct 2020,2020-10-12,54262,7173565,78365,6224795,710,109894
13 Oct 2020,2020-10-13,63717,7237282,74079,6298874,727,110621
14 Oct 2020,2020-10-14,67811,7305093,81582,6380456,690,111311
15 Oct 2020,2020-10-15,63441,7368534,70792,6451248,882,112193
16 Oct 2020,2020-10-16,62304,7430838,70568,6521816,840,113033
17 Oct 2020,2020-10-17,61893,7492731,72583,6594399,1032,114065
18 Oct 2020,2020-10-18,56519,7549250,66418,6660817,582,114647
19 Oct 2020,2020-10-19,45506,7594756,69800,6730617,589,115236
20 Oct 2020,2020-10-20,54348,7649104,61828,6792445,714,115950
21 Oct 2020,2020-10-21,56264,7705368,79561,6872006,701,116651
22 Oct 2020,2020-10-22,54371,7759739,74569,6946575,686,117337
23 Oct 2020,2020-10-23,53931,7813670,66994,7013569,655,117992
24 Oct 2020,2020-10-24,50366,7864036,62270,7075839,578,118570
25 Oct 2020,2020-10-25,45922,7909958,59304,7135143,483,119053
26 Oct 2020,2020-10-26,36104,7946062,63873,7199016,491,119544
27 Oct 2020,2020-10-27,43036,7989098,58429,7257445,511,120055
28 Oct 2020,2020-10-28,50188,8039286,56594,7314039,515,120570
29 Oct 2020,2020-10-29,48765,8088051,57867,7371906,562,121132
30 Oct 2020,2020-10-30,48117,8136168,59005,7430911,550,121682
31 Oct 2020,2020-10-31,47228,8183396,58682,7489593,469,122151
01 Nov 2020,2020-11-01,45928,8229324,53312,7542905,491,122642
02 Nov 2020,2020-11-02,37592,8266916,58524,7601429,498,123140
03 Nov 2020,2020-11-03,46027,8312943,53328,7654757,510,123650
04 Nov 2020,2020-11-04,50465,8363408,55873,7710630,707,124357
05 Nov 2020,2020-11-05,47628,8411036,54133,7764763,672,125029
06 Nov 2020,2020-11-06,50359,8461395,53992,7818755,577,125606
07 Nov 2020,2020-11-07,45811,8507206,48536,7867291,557,126163
08 Nov 2020,2020-11-08,46707,8553913,48465,7915756,490,126653
09 Nov 2020,2020-11-09,37119,8591032,41449,7957205,450,127103
10 Nov 2020,2020-11-10,44724,8635756,54639,8011844,511,127614
11 Nov 2020,2020-11-11,48285,8684041,52704,8064548,550,128164
12 Nov 2020,2020-11-12,44584,8728625,49354,8113902,544,128708
13 Nov 2020,2020-11-13,44620,8773245,47620,8161522,517,129225
14 Nov 2020,2020-11-14,41692,8814937,42317,8203839,450,129675
15 Nov 2020,2020-11-15,30681,8845618,44111,8247950,434,130109
16 Nov 2020,2020-11-16,28609,8874227,40392,8288342,451,130560
17 Nov 2020,2020-11-17,38548,8912775,44753,8333095,472,131032
18 Nov 2020,2020-11-18,45366,8958141,48675,8381770,586,131618
19 Nov 2020,2020-11-19,46185,9004326,45246,8427016,582,132200
20 Nov 2020,2020-11-20,46283,9050609,48968,8475984,564,132764
21 Nov 2020,2020-11-21,45301,9095910,44055,8520039,499,133263
22 Nov 2020,2020-11-22,44404,9140314,41405,8561444,510,133773
23 Nov 2020,2020-11-23,37441,9177755,42195,8603639,481,134254
24 Nov 2020,2020-11-24,44245,9222000,37765,8641404,489,134743
25 Nov 2020,2020-11-25,44699,9266699,36582,8677986,518,135261
26 Nov 2020,2020-11-26,43174,9309873,39723,8717709,491,135752
27 Nov 2020,2020-11-27,41353,9351226,41177,8758886,486,136238
28 Nov 2020,2020-11-28,41815,9393041,42275,8801161,495,136733
29 Nov 2020,2020-11-29,39036,9432077,45152,8846313,444,137177
30 Nov 2020,2020-11-30,31179,9463256,42282,8888595,482,137659
01 Dec 2020,2020-12-01,36474,9499730,43208,8931803,501,138160
02 Dec 2020,2020-12-02,35506,9535236,40908,8972711,526,138686
03 Dec 2020,2020-12-03,36574,9571810,42991,9015702,541,139227
04 Dec 2020,2020-12-04,36711,9608521,42359,9058061,511,139738
05 Dec 2020,2020-12-05,36010,9644531,41885,9099946,482,140220
06 Dec 2020,2020-12-06,33178,9677709,39078,9139024,390,140610
07 Dec 2020,2020-12-07,26227,9703936,39293,9178317,386,140996
08 Dec 2020,2020-12-08,32083,9736019,36583,9214900,402,141398
09 Dec 2020,2020-12-09,31637,9767656,37693,9252593,413,141811
10 Dec 2020,2020-12-10,29411,9797067,37707,9290300,411,142222
11 Dec 2020,2020-12-11,29961,9827028,33492,9323792,442,142664
12 Dec 2020,2020-12-12,30354,9857382,33087,9356879,391,143055
13 Dec 2020,2020-12-13,27336,9884718,30640,9387519,338,143393
14 Dec 2020,2020-12-14,21941,9906659,34421,9421940,354,143747
15 Dec 2020,2020-12-15,26251,9932910,33853,9455793,384,144131
16 Dec 2020,2020-12-16,18172,9951082,33360,9489153,356,144487
17 Dec 2020,2020-12-17,26754,9977836,30891,9520044,342,144829
18 Dec 2020,2020-12-18,26991,10004827,29879,9549923,342,145171
19 Dec 2020,2020-12-19,26834,10031661,29758,9579681,342,145513
20 Dec 2020,2020-12-20,24622,10056283,25734,9605415,332,145845
21 Dec 2020,2020-12-21,19147,10075430,30250,9635665,302,146147
22 Dec 2020,2020-12-22,23880,10099310,27032,9662697,329,146476
23 Dec 2020,2020-12-23,24716,10124026,29946,9692643,315,146791
24 Dec 2020,2020-12-24,23444,10147470,24555,9717198,337,147128
25 Dec 2020,2020-12-25,22349,10169819,22184,9739382,251,147379
26 Dec 2020,2020-12-26,18575,10188394,21466,9760848,280,147659
27 Dec 2020,2020-12-27,20333,10208727,21097,9781945,281,147940
28 Dec 2020,2020-12-28,16072,10224799,24822,9806767,250,148190
29 Dec 2020,2020-12-29,20542,10245341,26589,9833356,285,148475
30 Dec 2020,2020-12-30,21945,10267286,26407,9859763,299,148774
31 Dec 2020,2020-12-31,19026,10286312,21969,9881732,244,149018
01 Jan 2021,2021-01-01,20159,10306471,23838,9905570,237,149255
02 Jan 2021,2021-01-02,18144,10324615,20903,9926473,216,149471
03 Jan 2021,2021-01-03,16678,10341293,19658,9946131,215,149686
04 Jan 2021,2021-01-04,16278,10357571,29209,9975340,200,149886
05 Jan 2021,2021-01-05,17909,10375480,21161,9996501,265,150151
06 Jan 2021,2021-01-06,20472,10395952,19689,10016190,222,150373
07 Jan 2021,2021-01-07,18123,10414075,20503,10036693,233,150606
08 Jan 2021,2021-01-08,18453,10432528,19242,10055935,229,150835
09 Jan 2021,2021-01-09,18820,10451348,19460,10075395,213,151048
10 Jan 2021,2021-01-10,16086,10467434,16737,10092132,150,151198
11 Jan 2021,2021-01-11,12481,10479915,18578,10110710,166,151364
12 Jan 2021,2021-01-12,15903,10495818,17762,10128472,200,151564
13 Jan 2021,2021-01-13,17015,10512833,17797,10146269,201,151765
14 Jan 2021,2021-01-14,15677,10528510,15943,10162212,189,151954
15 Jan 2021,2021-01-15,15155,10543665,16809,10179021,176,152130
16 Jan 2021,2021-01-16,15050,10558715,17202,10196223,181,152311
17 Jan 2021,2021-01-17,13962,10572677,14513,10210736,145,152456
18 Jan 2021,2021-01-18,9987,10582664,17127,10227863,137,152593
19 Jan 2021,2021-01-19,13787,10596451,17229,10245092,162,152755
20 Jan 2021,2021-01-20,15279,10611730,20071,10265163,152,152907
21 Jan 2021,2021-01-21,14495,10626225,17734,10282897,161,153068
22 Jan 2021,2021-01-22,14323,10640548,17166,10300063,153,153221
23 Jan 2021,2021-01-23,14896,10655444,16033,10316096,156,153377
24 Jan 2021,2021-01-24,13232,10668676,13148,10329244,131,153508
25 Jan 2021,2021-01-25,9098,10677774,16092,10345336,116,153624
26 Jan 2021,2021-01-26,12733,10690507,13250,10358586,138,153762
27 Jan 2021,2021-01-27,11556,10702063,14261,10372847,123,153885
28 Jan 2021,2021-01-28,18912,10720975,20315,10393162,162,154047
29 Jan 2021,2021-01-29,13054,10734029,14886,10408048,137,154184
30 Jan 2021,2021-01-30,13073,10747102,14077,10422125,128,154312
31 Jan 2021,2021-01-31,11527,10758629,11882,10434007,116,154428
01 Feb 2021,2021-02-01,8579,10767208,13443,10447450,94,154522
02 Feb 2021,2021-02-02,11001,10778209,14250,10461700,113,154635
03 Feb 2021,2021-02-03,12925,10791134,17813,10479513,107,154742
04 Feb 2021,2021-02-04,12401,10803535,15788,10495301,120,154862
05 Feb 2021,2021-02-05,11711,10815246,14512,10509813,95,154957
06 Feb 2021,2021-02-06,12069,10827315,11761,10521574,75,155032
07 Feb 2021,2021-02-07,11786,10839101,11756,10533330,86,155118
08 Feb 2021,2021-02-08,8715,10847816,13600,10546930,78,155196
09 Feb 2021,2021-02-09,10731,10858547,12928,10559858,94,155290
10 Feb 2021,2021-02-10,12539,10871086,11796,10571654,110,155400
11 Feb 2021,2021-02-11,9353,10880439,15722,10587376,85,155485
12 Feb 2021,2021-02-12,12137,10892576,11358,10598734,104,155589
13 Feb 2021,2021-02-13,12198,10904774,11107,10609841,89,155678
14 Feb 2021,2021-02-14,11706,10916480,9500,10619341,91,155769
15 Feb 2021,2021-02-15,9086,10925566,11793,10631134,82,155851
16 Feb 2021,2021-02-16,11592,10937158,11836,10642970,99,155950
17 Feb 2021,2021-02-17,12862,10950020,12028,10654998,100,156050
18 Feb 2021,2021-02-18,13238,10963258,10913,10665911,100,156150
19 Feb 2021,2021-02-19,13916,10977174,10215,10676126,100,156250
20 Feb 2021,2021-02-20,13919,10991093,11413,10687539,89,156339
21 Feb 2021,2021-02-21,14278,11005371,9715,10697254,83,156422
22 Feb 2021,2021-02-22,10494,11015865,13233,10710487,76,156498
23 Feb 2021,2021-02-23,13682,11029547,13969,10724456,103,156601
24 Feb 2021,2021-02-24,16930,11046477,12100,10736556,141,156742
25 Feb 2021,2021-02-25,16599,11063076,12222,10748778,119,156861
26 Feb 2021,2021-02-26,16562,11079638,12790,10761568,114,156975
27 Feb 2021,2021-02-27,16805,11096443,11709,10773277,111,157086
28 Feb 2021,2021-02-28,15614,11112057,11291,10784568,108,157194
01 Mar 2021,2021-03-01,12270,11124327,12472,10797040,92,157286
02 Mar 2021,2021-03-02,14998,11139325,13113,10810153,98,157384
03 Mar 2021,2021-03-03,17425,11156750,14071,10824224,87,157471
04 Mar 2021,2021-03-04,16824,11173574,13788,10838012,113,157584
05 Mar 2021,2021-03-05,18324,11191898,14186,10852198,109,157693
06 Mar 2021,2021-03-06,18724,11210622,14379,10866577,100,157793
07 Mar 2021,2021-03-07,18650,11229272,14303,10880880,97,157890
08 Mar 2021,2021-03-08,15353,11244625,16606,10897486,76,157966
09 Mar 2021,2021-03-09,17873,11262498,20643,10918129,133,158099
10 Mar 2021,2021-03-10,22851,11285349,18154,10936283,125,158224
11 Mar 2021,2021-03-11,23298,11308647,15092,10951375,119,158343
12 Mar 2021,2021-03-12,24845,11333492,19972,10971347,140,158483
13 Mar 2021,2021-03-13,25154,11358646,16508,10987855,159,158642
14 Mar 2021,2021-03-14,26513,11385159,17590,11005445,120,158762
15 Mar 2021,2021-03-15,24437,11409596,20186,11025631,130,158892
16 Mar 2021,2021-03-16,28869,11438465,17746,11043377,187,159079
17 Mar 2021,2021-03-17,35838,11474303,17793,11061170,171,159250
18 Mar 2021,2021-03-18,39687,11513990,20356,11081526,156,159406
19 Mar 2021,2021-03-19,40906,11554896,23623,11105149,188,159594
20 Mar 2021,2021-03-20,43815,11598711,22971,11128120,196,159790
21 Mar 2021,2021-03-21,47009,11645720,21205,11149325,213,160003
22 Mar 2021,2021-03-22,40636,11686356,29779,11179104,197,160200
23 Mar 2021,2021-03-23,47239,11733595,23913,11203017,277,160477
24 Mar 2021,2021-03-24,53419,11787014,26575,11229592,249,160726
25 Mar 2021,2021-03-25,59085,11846099,32916,11262508,257,160983
26 Mar 2021,2021-03-26,62276,11908375,30341,11292849,292,161275
27 Mar 2021,2021-03-27,62632,11971007,28728,11321577,311,161586
28 Mar 2021,2021-03-28,68206,12039213,32269,11353846,295,161881
29 Mar 2021,2021-03-29,56152,12095365,36989,11390835,266,162147
30 Mar 2021,2021-03-30,53237,12148602,41242,11432077,355,162502
31 Mar 2021,2021-03-31,72115,12220717,40423,11472500,458,162960
01 Apr 2021,2021-04-01,81398,12302115,50384,11522884,468,163428
02 Apr 2021,2021-04-02,89023,12391138,44179,11567063,713,164141
03 Apr 2021,2021-04-03,92994,12484132,60059,11627122,514,164655
04 Apr 2021,2021-04-04,103794,12587926,52840,11679962,477,165132
05 Apr 2021,2021-04-05,96563,12684489,50100,11730062,446,165578
06 Apr 2021,2021-04-06,115312,12799801,59714,11789776,630,166208
07 Apr 2021,2021-04-07,126276,12926077,59137,11848913,684,166892
08 Apr 2021,2021-04-08,131878,13057955,61829,11910742,802,167694
09 Apr 2021,2021-04-09,144997,13202952,77303,11988045,773,168467
10 Apr 2021,2021-04-10,152565,13355517,90328,12078373,838,169305
11 Apr 2021,2021-04-11,169915,13525432,75380,12153753,904,170209
12 Apr 2021,2021-04-12,160854,13686286,96746,12250499,880,171089
13 Apr 2021,2021-04-13,185306,13871592,82271,12332770,1026,172115
14 Apr 2021,2021-04-14,199584,14071176,93425,12426195,1038,173153
15 Apr 2021,2021-04-15,216838,14288014,117899,12544094,1184,174337
16 Apr 2021,2021-04-16,234002,14522016,122886,12666980,1338,175675
17 Apr 2021,2021-04-17,260895,14782911,138209,12805189,1498,177173
18 Apr 2021,2021-04-18,275083,15057994,143839,12949028,1620,178793
19 Apr 2021,2021-04-19,257017,15315011,154369,13103397,1757,180550
20 Apr 2021,2021-04-20,294378,15609389,166668,13270065,2021,182571
21 Apr 2021,2021-04-21,315752,15925141,179434,13449499,2101,184672
22 Apr 2021,2021-04-22,332531,16257672,192317,13641816,2257,186929
23 Apr 2021,2021-04-23,345296,16602968,220545,13862361,2620,189549
24 Apr 2021,2021-04-24,348996,16951964,215809,14078170,2761,192310
25 Apr 2021,2021-04-25,354658,17306622,218626,14296796,2808,195118
26 Apr 2021,2021-04-26,319471,17626093,249009,14545805,2762,197880
27 Apr 2021,2021-04-27,362913,17989006,262349,14808154,3286,201166
28 Apr 2021,2021-04-28,379403,18368409,274171,15082325,3646,204812
29 Apr 2021,2021-04-29,386773,18755182,291727,15374052,3502,208314
30 Apr 2021,2021-04-30,402014,19157196,299198,15673250,3525,211839
01 May 2021,2021-05-01,392576,19549772,308688,15981938,3685,215524
02 May 2021,2021-05-02,370090,19919862,300004,16281942,3423,218947
03 May 2021,2021-05-03,355769,20275631,318910,16600852,3439,222386
04 May 2021,2021-05-04,382847,20658478,337698,16938550,3786,226172
05 May 2021,2021-05-05,412624,21071102,330718,17269268,3979,230151
06 May 2021,2021-05-06,414280,21485382,328349,17597617,3923,234074
07 May 2021,2021-05-07,406901,21892283,327675,17925292,4233,238307
08 May 2021,2021-05-08,403808,22296091,386395,18311687,4092,242399
09 May 2021,2021-05-09,366455,22662546,353777,18665464,3749,246148
10 May 2021,2021-05-10,329491,22992037,355930,19021394,3879,250027
11 May 2021,2021-05-11,348555,23340592,355398,19376792,4198,254225
12 May 2021,2021-05-12,362632,23703224,352005,19728797,4128,258353
13 May 2021,2021-05-13,343005,24046229,344676,20073473,4000,262353
14 May 2021,2021-05-14,326256,24372485,353200,20426673,3889,266242
15 May 2021,2021-05-15,310757,24683242,362547,20789220,4077,270319
16 May 2021,2021-05-16,281837,24965079,378526,21167746,4098,274417
17 May 2021,2021-05-17,263021,25228100,422391,21590137,4334,278751
18 May 2021,2021-05-18,267246,25495346,389758,21979895,4529,283280
19 May 2021,2021-05-19,276187,25771533,369005,22348900,3877,287157
20 May 2021,2021-05-20,259242,26030775,357173,22706073,4209,291366
21 May 2021,2021-05-21,257299,26288074,357625,23063698,4194,295560
22 May 2021,2021-05-22,240897,26528971,355138,23418836,3739,299299
23 May 2021,2021-05-23,222834,26751805,302253,23721089,4454,303753
24 May 2021,2021-05-24,195857,26947662,326737,24047826,3509,307262
25 May 2021,2021-05-25,208992,27156654,295264,24343090,4160,311422
26 May 2021,2021-05-26,211510,27368164,283054,24626144,3843,315265
27 May 2021,2021-05-27,186075,27554239,271002,24897146,3659,318924
28 May 2021,2021-05-28,174083,27728322,285332,25182478,3611,322535
29 May 2021,2021-05-29,165282,27893604,264483,25446961,3463,325998
30 May 2021,2021-05-30,153396,28047000,237664,25684625,3130,329128
31 May 2021,2021-05-31,126883,28173883,255125,25939750,2783,331911
01 Jun 2021,2021-06-01,133152,28307035,231397,26171147,3205,335116
02 Jun 2021,2021-06-02,134044,28441079,211890,26383037,2898,338014
03 Jun 2021,2021-06-03,132424,28573503,206722,26589759,2717,340731
04 Jun 2021,2021-06-04,120454,28693957,197763,26787522,3372,344103
05 Jun 2021,2021-06-05,114488,28808445,189374,26976896,2682,346785
06 Jun 2021,2021-06-06,101209,28909654,174156,27151052,2444,349229
07 Jun 2021,2021-06-07,85804,28995458,182866,27333918,2107,351336
08 Jun 2021,2021-06-08,92787,29088245,162356,27496274,2222,353558
09 Jun 2021,2021-06-09,93883,29182128,149022,27645296,6139,359697
10 Jun 2021,2021-06-10,91849,29273977,135329,27780625,3414,363111
11 Jun 2021,2021-06-11,84574,29358551,122685,27903310,3996,367107
12 Jun 2021,2021-06-12,80525,29439076,132664,28035974,3300,370407
13 Jun 2021,2021-06-13,71001,29510077,119574,28155548,3922,374329
14 Jun 2021,2021-06-14,60008,29570085,117376,28272924,2733,377062
15 Jun 2021,2021-06-15,62217,29632302,107776,28380700,2540,379602
16 Jun 2021,2021-06-16,67289,29699591,103900,28484600,2329,381931
17 Jun 2021,2021-06-17,62436,29762027,88500,28573100,1591,383522
18 Jun 2021,2021-06-18,60765,29822792,97854,28670954,1645,385167
19 Jun 2021,2021-06-19,58615,29881407,87548,28758502,1574,386741
20 Jun 2021,2021-06-20,52978,29934385,78189,28836691,1424,388165
21 Jun 2021,2021-06-21,42683,29977068,82031,28918722,1167,389332
22 Jun 2021,2021-06-22,50817,30027885,68697,28987419,1359,390691
23 Jun 2021,2021-06-23,54309,30082194,69187,29056606,1323,392014
24 Jun 2021,2021-06-24,51659,30133853,64369,29120975,1328,393342
25 Jun 2021,2021-06-25,48768,30182621,64819,29185794,1183,394525
26 Jun 2021,2021-06-26,49844,30232465,57866,29243660,1258,395783
27 Jun 2021,2021-06-27,46523,30278988,58563,29302223,978,396761
28 Jun 2021,2021-06-28,37070,30316058,57016,29359239,907,397668
29 Jun 2021,2021-06-29,46104,30362162,60789,29420028,819,398487
30 Jun 2021,2021-06-30,48606,30410768,61813,29481841,1002,399489
01 Jul 2021,2021-07-01,46781,30457549,59054,29540895,857,400346
02 Jul 2021,2021-07-02,44187,30501736,57497,29598392,737,401083
03 Jul 2021,2021-07-03,43027,30544763,52270,29650662,950,402033
04 Jul 2021,2021-07-04,40150,30584913,42342,29693004,725,402758
05 Jul 2021,2021-07-05,34026,30618939,51933,29744937,552,403310
06 Jul 2021,2021-07-06,43964,30662903,47054,29791991,930,404240
07 Jul 2021,2021-07-07,45701,30708604,44529,29836520,819,405059
08 Jul 2021,2021-07-08,43504,30752108,44204,29880724,908,405967
09 Jul 2021,2021-07-09,42660,30794768,45291,29926015,1207,407174
10 Jul 2021,2021-07-10,41494,30836262,41511,29967526,898,408072
11 Jul 2021,2021-07-11,37654,30873916,39688,30007214,720,408792
12 Jul 2021,2021-07-12,30818,30904734,47544,30054758,2024,410816
13 Jul 2021,2021-07-13,40314,30945048,42436,30097194,625,411441
14 Jul 2021,2021-07-14,41759,30986807,39293,30136487,578,412019
15 Jul 2021,2021-07-15,39071,31025878,39827,30176314,544,412563
16 Jul 2021,2021-07-16,38117,31063995,43878,30220192,560,413123
17 Jul 2021,2021-07-17,41283,31105278,42051,30262243,517,413640
18 Jul 2021,2021-07-18,38330,31143608,38545,30300788,501,414141
19 Jul 2021,2021-07-19,29420,31173028,45356,30346144,372,414513
20 Jul 2021,2021-07-20,42128,31215156,36876,30383020,3998,418511
21 Jul 2021,2021-07-21,41687,31256843,38891,30421911,510,419021
22 Jul 2021,2021-07-22,34863,31291706,38403,30460314,480,419501
23 Jul 2021,2021-07-23,39501,31331207,35145,30495459,542,420043
24 Jul 2021,2021-07-24,40286,31371493,40038,30535497,541,420584
25 Jul 2021,2021-07-25,38179,31409672,35945,30571442,411,420995
26 Jul 2021,2021-07-26,30820,31440492,42503,30613945,418,421413
27 Jul 2021,2021-07-27,42971,31483463,41653,30655598,641,422054
28 Jul 2021,2021-07-28,43165,31526628,38537,30694135,640,422694
29 Jul 2021,2021-07-29,44671,31571299,42115,30736250,549,423243
30 Jul 2021,2021-07-30,41499,31612798,37320,30773570,598,423841
31 Jul 2021,2021-07-31,41943,31654741,39487,30813057,542,424383
01 Aug 2021,2021-08-01,40629,31695370,36628,30849685,424,424807
02 Aug 2021,2021-08-02,30085,31725455,39120,30888805,420,425227
03 Aug 2021,2021-08-03,42530,31767985,36552,30925357,561,425788
04 Aug 2021,2021-08-04,42797,31810782,41873,30967230,532,426320
05 Aug 2021,2021-08-05,45005,31855787,40906,31008136,465,426785
06 Aug 2021,2021-08-06,38705,31894492,40026,31048162,616,427401
07 Aug 2021,2021-08-07,39068,31933560,43935,31092097,491,427892
08 Aug 2021,2021-08-08,36036,31969596,39832,31131929,447,428339
09 Aug 2021,2021-08-09,27428,31997024,41461,31173390,376,428715
10 Aug 2021,2021-08-10,38380,32035404,40097,31213487,496,429211
11 Aug 2021,2021-08-11,41586,32076990,39127,31252614,491,429702
12 Aug 2021,2021-08-12,40081,32117071,42156,31294770,583,430285
13 Aug 2021,2021-08-13,38761,32155832,35759,31330529,477,430762
14 Aug 2021,2021-08-14,36135,32191967,37936,31368465,491,431253
15 Aug 2021,2021-08-15,33245,32225212,35936,31404401,421,431674
16 Aug 2021,2021-08-16,24696,32249908,36871,31441272,438,432112
17 Aug 2021,2021-08-17,35208,32285116,37143,31478415,440,432552
18 Aug 2021,2021-08-18,36502,32321618,39269,31517684,527,433079
19 Aug 2021,2021-08-19,36600,32358218,36457,31554141,543,433622
20 Aug 2021,2021-08-20,34308,32392526,36285,31590426,376,433998
21 Aug 2021,2021-08-21,31023,32423549,38577,31629003,401,434399
22 Aug 2021,2021-08-22,25420,32448969,44103,31673106,385,434784
23 Aug 2021,2021-08-23,24794,32473763,39553,31712659,357,435141
24 Aug 2021,2021-08-24,37739,32511502,34148,31746807,650,435791
25 Aug 2021,2021-08-25,46129,32557631,34248,31781055,605,436396
26 Aug 2021,2021-08-26,44550,32602181,32925,31813980,493,436889
27 Aug 2021,2021-08-27,46806,32648987,31343,31845323,514,437403
28 Aug 2021,2021-08-28,45064,32694051,35811,31881134,457,437860
29 Aug 2021,2021-08-29,43374,32737425,34843,31915977,527,438387
30 Aug 2021,2021-08-30,30248,32767673,36240,31952217,205,438592
31 Aug 2021,2021-08-31,43073,32810746,34112,31986329,462,439054
01 Sep 2021,2021-09-01,45975,32856721,35091,32021420,507,439561
02 Sep 2021,2021-09-02,45624,32902345,34665,32056085,355,439916
03 Sep 2021,2021-09-03,42667,32945012,36422,32092507,342,440258
04 Sep 2021,2021-09-04,42607,32987619,38087,32130594,309,440567
05 Sep 2021,2021-09-05,39537,33027156,43922,32174516,218,440785
06 Sep 2021,2021-09-06,30164,33057320,42946,32217462,290,441075
07 Sep 2021,2021-09-07,38135,33095455,39101,32256563,368,441443
08 Sep 2021,2021-09-08,43401,33138856,40620,32297183,339,441782
09 Sep 2021,2021-09-09,24151,33163007,24397,32321580,258,442040
10 Sep 2021,2021-09-10,37875,33200882,36671,32358251,310,442350
11 Sep 2021,2021-09-11,31288,33232170,37886,32396137,338,442688
12 Sep 2021,2021-09-12,31441,33263611,40699,32436836,219,442907
13 Sep 2021,2021-09-13,24414,33288025,39815,32476651,340,443247
14 Sep 2021,2021-09-14,27502,33315527,37993,32514644,281,443528
15 Sep 2021,2021-09-15,30355,33345882,38353,32552997,432,443960
16 Sep 2021,2021-09-16,34653,33380535,37888,32590885,318,444278
17 Sep 2021,2021-09-17,35354,33415889,33833,32624718,285,444563
18 Sep 2021,2021-09-18,31130,33447019,39652,32664370,306,444869
19 Sep 2021,2021-09-19,30828,33477847,43217,32707587,296,445165
20 Sep 2021,2021-09-20,24907,33502754,34470,32742057,251,445416
21 Sep 2021,2021-09-21,27338,33530092,34160,32776217,385,445801
22 Sep 2021,2021-09-22,32010,33562102,31997,32808214,280,446081
23 Sep 2021,2021-09-23,31411,33593513,32510,32840724,318,446399
24 Sep 2021,2021-09-24,29565,33623078,28049,32868773,291,446690
25 Sep 2021,2021-09-25,28169,33651247,26021,32894794,259,446949
26 Sep 2021,2021-09-26,26999,33678246,29625,32924419,276,447225
27 Sep 2021,2021-09-27,14907,33693153,24251,32948670,181,447406
28 Sep 2021,2021-09-28,21898,33715051,29944,32978614,375,447781
29 Sep 2021,2021-09-29,23166,33738217,28726,33007340,313,448094
30 Sep 2021,2021-09-30,27285,33765502,28204,33035544,278,448372
01 Oct 2021,2021-10-01,23918,33789420,25460,33061004,233,448605
02 Oct 2021,2021-10-02,23189,33812609,25938,33086942,242,448847
03 Oct 2021,2021-10-03,21644,33834253,26724,33113666,182,449029
04 Oct 2021,2021-10-04,17101,33851354,29645,33143311,263,449292
05 Oct 2021,2021-10-05,19044,33870398,24761,33168072,276,449568
06 Oct 2021,2021-10-06,22605,33893003,24610,33192682,316,449884
07 Oct 2021,2021-10-07,21474,33914477,24959,33217641,277,450161
08 Oct 2021,2021-10-08,19868,33934345,23066,33240707,247,450408
09 Oct 2021,2021-10-09,17931,33952276,23595,33264302,213,450621
10 Oct 2021,2021-10-10,19020,33971296,21583,33285885,193,450814
11 Oct 2021,2021-10-11,13184,33984480,26573,33312458,177,450991
12 Oct 2021,2021-10-12,16023,34000503,22846,33335304,229,451220
13 Oct 2021,2021-10-13,19193,34019696,19811,33355115,249,451469
14 Oct 2021,2021-10-14,16988,34036684,19370,33374485,378,451847
15 Oct 2021,2021-10-15,16003,34052687,17868,33392353,163,452010
16 Oct 2021,2021-10-16,14078,34066765,19786,33412139,146,452156
17 Oct 2021,2021-10-17,14286,34081051,19579,33431718,165,452321
18 Oct 2021,2021-10-18,12339,34093390,19460,33451178,164,452485
19 Oct 2021,2021-10-19,14935,34108325,19445,33470623,199,452684
20 Oct 2021,2021-10-20,18382,34126707,17568,33488191,160,452844
21 Oct 2021,2021-10-21,15774,34142481,18642,33506833,232,453076
22 Oct 2021,2021-10-22,16327,34158808,17636,33524469,666,453742
23 Oct 2021,2021-10-23,16079,34174887,16509,33540978,559,454301
24 Oct 2021,2021-10-24,14654,34189541,18608,33559586,442,454743
25 Oct 2021,2021-10-25,11852,34201393,16102,33575688,357,455100
26 Oct 2021,2021-10-26,13499,34214892,14012,33589700,584,455684
27 Oct 2021,2021-10-27,16351,34231243,17077,33606777,734,456418
28 Oct 2021,2021-10-28,14307,34245550,13189,33619966,805,457223
29 Oct 2021,2021-10-29,14215,34259765,13549,33633515,551,457774
30 Oct 2021,2021-10-30,12940,34272705,14672,33648187,445,458219
31 Oct 2021,2021-10-31,12907,34285612,13152,33661339,251,458470
01 Nov 2021,2021-11-01,9770,34295382,14553,33675892,439,458909
02 Nov 2021,2021-11-02,12087,34307469,14206,33690098,303,459212
03 Nov 2021,2021-11-03,13028,34320497,14387,33704485,451,459663
04 Nov 2021,2021-11-04,12580,34333077,12170,33716655,216,459879
05 Nov 2021,2021-11-05,10949,34344026,12255,33728910,388,460267
06 Nov 2021,2021-11-06,11027,34355053,12102,33741012,520,460787
07 Nov 2021,2021-11-07,11725,34366778,13180,33754192,262,461049
08 Nov 2021,2021-11-08,9535,34376313,11891,33766083,325,461374
09 Nov 2021,2021-11-09,11766,34388079,10649,33776732,455,461829
10 Nov 2021,2021-11-10,12072,34400151,13522,33790254,120,461949
11 Nov 2021,2021-11-11,12388,34412539,12742,33802996,490,462439
12 Nov 2021,2021-11-12,11797,34424336,12389,33815385,548,462987
13 Nov 2021,2021-11-13,10354,34434690,10017,33825402,222,463209
14 Nov 2021,2021-11-14,10376,34445066,11908,33837310,124,463333
15 Nov 2021,2021-11-15,8449,34453515,11585,33848895,193,463526
16 Nov 2021,2021-11-16,10371,34463886,12092,33860987,300,463826
17 Nov 2021,2021-11-17,11813,34475699,11129,33872116,468,464294
18 Nov 2021,2021-11-18,11194,34486893,12468,33884584,452,464746
19 Nov 2021,2021-11-19,10461,34497354,11486,33896070,266,465012
20 Nov 2021,2021-11-20,10355,34507709,12087,33908157,96,465108
21 Nov 2021,2021-11-21,9229,34516938,12227,33920384,243,465351
22 Nov 2021,2021-11-22,7398,34524336,12084,33932468,234,465585
23 Nov 2021,2021-11-23,9391,34533727,10742,33943210,436,466021
24 Nov 2021,2021-11-24,9196,34542923,10147,33953357,392,466413
25 Nov 2021,2021-11-25,10392,34553315,9775,33963132,484,466897
26 Nov 2021,2021-11-26,9297,34562612,10824,33973956,467,467364
27 Nov 2021,2021-11-27,9067,34571679,9431,33983387,614,467978
28 Nov 2021,2021-11-28,8958,34580637,9312,33992699,625,468603
29 Nov 2021,2021-11-29,6689,34587326,9965,34002664,187,468790
30 Nov 2021,2021-11-30,8997,34596323,10021,34012685,267,469057
01 Dec 2021,2021-12-01,9875,34606198,8533,34021218,474,469531
02 Dec 2021,2021-12-02,9191,34615389,8603,34029821,388,469919
03 Dec 2021,2021-12-03,9128,34624517,9039,34038860,332,470251
04 Dec 2021,2021-12-04,8912,34633429,9345,34048205,2784,473035
05 Dec 2021,2021-12-05,8413,34641842,8804,34057009,228,473263
06 Dec 2021,2021-12-06,6648,34648490,10008,34067017,234,473497
07 Dec 2021,2021-12-07,8607,34657097,9512,34076529,214,473711
08 Dec 2021,2021-12-08,9303,34666400,8252,34084781,156,473867
09 Dec 2021,2021-12-09,8612,34675012,7986,34092767,625,474492
10 Dec 2021,2021-12-10,7971,34682983,9061,34101828,393,474885
11 Dec 2021,2021-12-11,7748,34690731,8454,34110282,307,475192
12 Dec 2021,2021-12-12,7492,34698223,7891,34118173,196,475388
13 Dec 2021,2021-12-13,,34698223,,34118173,,475388
